+-+-+-+-+-+-+-+-+-+-+-+-+
|   | |   | |   | |   | |
+ +-+ +-+ + + +-+ +-+ + +
| | |   | |   | |   | | |
+ + +-+ + + +-+ +-+ + + +
| |   | |   | |   | |   |
+ +-+ + + +-+ +-+ + + +-+
|   | |   | |   | |   | |
+-+ + + +-+ +-+ + + +-+ +
| | |   | |   | |   | | |
+ + + +-+ +-+ + + +-+ + +
| |   | |   | |   | |   |
+ + +-+ +-+ + + +-+ +-+ +
|   | |   | |   | |   | |
+ +-+ +-+ + + +-+ +-+ + +
|                       |
+-+-+-+-+-+-+-+-+-+-+-+-+
