+-+-+-+-+-+
| | |   | |
+ + + +-+ +
| |   | | |
+ + +-+ + +
|   | |   |
+ +-+ +-+ +
| | |   | |
+ + +-+ + +
|         |
+-+-+-+-+-+
